8 9 24
6 6 6 6 6 6 6 6 6
6 6 6 6 6 0 1 6 6
6 6 0 0 2 0 0 6 6
6 6 0 2 0 2 6 6 6
6 0 0 6 6 6 6 6 6
6 0 3 0 0 3 0 6 6
6 0 3 0 3 0 0 4 6
6 6 6 6 6 6 6 6 6